Gene	Oligo-program	Astro-program	Stemness-program
OLIG1	TRUE	FALSE	FALSE
NEU4	TRUE	FALSE	FALSE
GPR17	TRUE	FALSE	FALSE
SLC1A1	TRUE	FALSE	FALSE
ATCAY	TRUE	FALSE	FALSE
SIRT2	TRUE	FALSE	FALSE
APOD	TRUE	FALSE	FALSE
MYT1	TRUE	FALSE	FALSE
OLIG2	TRUE	FALSE	FALSE
TMEFF2	TRUE	FALSE	FALSE
OMG	TRUE	FALSE	FALSE
ELMO1	TRUE	FALSE	FALSE
RTKN	TRUE	FALSE	FALSE
HIP1R	TRUE	FALSE	FALSE
TNR	TRUE	FALSE	FALSE
RPSA	TRUE	FALSE	FALSE
MEGF11	TRUE	FALSE	FALSE
EVI2A	TRUE	FALSE	FALSE
OPCML	TRUE	FALSE	FALSE
LHFPL3	TRUE	FALSE	FALSE
RAB33A	TRUE	FALSE	FALSE
GRIA4	TRUE	FALSE	FALSE
SERINC5	TRUE	FALSE	FALSE
NXPH1	TRUE	FALSE	FALSE
BIN1	TRUE	FALSE	FALSE
BMP4	TRUE	FALSE	FALSE
EHD3	TRUE	FALSE	FALSE
GNAI1	TRUE	FALSE	FALSE
CSPG4	TRUE	FALSE	FALSE
DSCAM	TRUE	FALSE	FALSE
GALNT13	TRUE	FALSE	FALSE
ZDHHC9	TRUE	FALSE	FALSE
ABCG1	TRUE	FALSE	FALSE
FKBP1A	TRUE	FALSE	FALSE
LRRN1	TRUE	FALSE	FALSE
ST8SIA3	TRUE	FALSE	FALSE
DNM3	TRUE	FALSE	FALSE
RAPGEF4	TRUE	FALSE	FALSE
CNP	TRUE	FALSE	FALSE
PDGFRA	TRUE	FALSE	FALSE
PTGDS	TRUE	FALSE	FALSE
CHGA	TRUE	FALSE	FALSE
BCAS1	TRUE	FALSE	FALSE
PLXNB3	TRUE	FALSE	FALSE
NFASC	TRUE	FALSE	FALSE
SLC44A1	TRUE	FALSE	FALSE
GNG4	TRUE	FALSE	FALSE
PHLDB1	TRUE	FALSE	FALSE
CD82	TRUE	FALSE	FALSE
PRKCZ	TRUE	FALSE	FALSE
APOE	FALSE	TRUE	FALSE
SPARCL1	FALSE	TRUE	FALSE
VIM	FALSE	TRUE	FALSE
ID4	FALSE	TRUE	FALSE
TIMP3	FALSE	TRUE	FALSE
EDNRB	FALSE	TRUE	FALSE
MLC1	FALSE	TRUE	FALSE
ID3	FALSE	TRUE	FALSE
CLU	FALSE	TRUE	FALSE
TNC	FALSE	TRUE	FALSE
ZFP36L1	FALSE	TRUE	FALSE
ARHGEF26	FALSE	TRUE	FALSE
ATP1B2	FALSE	TRUE	FALSE
AGT	FALSE	TRUE	FALSE
RGMA	FALSE	TRUE	FALSE
JUN	FALSE	TRUE	FALSE
PFKFB3	FALSE	TRUE	FALSE
EZR	FALSE	TRUE	FALSE
SLC1A3	FALSE	TRUE	FALSE
ALDOC	FALSE	TRUE	FALSE
JUNB	FALSE	TRUE	FALSE
ATP1A2	FALSE	TRUE	FALSE
DTNA	FALSE	TRUE	FALSE
ZFP36	FALSE	TRUE	FALSE
SOX9	FALSE	TRUE	FALSE
TRIL	FALSE	TRUE	FALSE
NDRG2	FALSE	TRUE	FALSE
NMB	FALSE	TRUE	FALSE
GFAP	FALSE	TRUE	FALSE
SLC1A2	FALSE	TRUE	FALSE
RFX4	FALSE	TRUE	FALSE
MALAT1	FALSE	TRUE	FALSE
LRIG1	FALSE	TRUE	FALSE
FOS	FALSE	TRUE	FALSE
EGR1	FALSE	TRUE	FALSE
STK17B	FALSE	TRUE	FALSE
FOSB	FALSE	TRUE	FALSE
ATF3	FALSE	TRUE	FALSE
ABCA1	FALSE	TRUE	FALSE
ADCYAP1R1	FALSE	TRUE	FALSE
GLUL	FALSE	TRUE	FALSE
IER2	FALSE	TRUE	FALSE
ZFP36L2	FALSE	TRUE	FALSE
ADHFE1	FALSE	TRUE	FALSE
MSI2	FALSE	TRUE	FALSE
CPE	FALSE	TRUE	FALSE
KLF6	FALSE	TRUE	FALSE
DOCK7	FALSE	TRUE	FALSE
IRF2BP2	FALSE	TRUE	FALSE
SPRY2	FALSE	TRUE	FALSE
SOX4	FALSE	FALSE	TRUE
DCX	FALSE	FALSE	TRUE
IGFBPL1	FALSE	FALSE	TRUE
SOX11	FALSE	FALSE	TRUE
TCF4	FALSE	FALSE	TRUE
NREP	FALSE	FALSE	TRUE
RND3	FALSE	FALSE	TRUE
CCND2	FALSE	FALSE	TRUE
MIAT	FALSE	FALSE	TRUE
CAMK2N1	FALSE	FALSE	TRUE
STMN4	FALSE	FALSE	TRUE
STMN1	FALSE	FALSE	TRUE
MYT1L	FALSE	FALSE	TRUE
HN1	FALSE	FALSE	TRUE
RNF122	FALSE	FALSE	TRUE
PROX1	FALSE	FALSE	TRUE
KLHDC8A	FALSE	FALSE	TRUE
ELAVL4	FALSE	FALSE	TRUE
NMNAT2	FALSE	FALSE	TRUE
TUBB	FALSE	FALSE	TRUE
ROBO1	FALSE	FALSE	TRUE
NELL2	FALSE	FALSE	TRUE
MLLT11	FALSE	FALSE	TRUE
CELF4	FALSE	FALSE	TRUE
POU3F2	FALSE	FALSE	TRUE
H3F3B	FALSE	FALSE	TRUE
ENC1	FALSE	FALSE	TRUE
GNG2	FALSE	FALSE	TRUE
ACOT7	FALSE	FALSE	TRUE
AKT3	FALSE	FALSE	TRUE
ARL4C	FALSE	FALSE	TRUE
FNBP1L	FALSE	FALSE	TRUE
VOPP1	FALSE	FALSE	TRUE
TOX3	FALSE	FALSE	TRUE
TUBB3	FALSE	FALSE	TRUE
SCG2	FALSE	FALSE	TRUE
TMSB15A	FALSE	FALSE	TRUE
TFDP2	FALSE	FALSE	TRUE
TMSB4X	FALSE	FALSE	TRUE
CDC42	FALSE	FALSE	TRUE
STMN2	FALSE	FALSE	TRUE
KCTD13	FALSE	FALSE	TRUE
RPH3A	FALSE	FALSE	TRUE
KIF5C	FALSE	FALSE	TRUE
NFIX	FALSE	FALSE	TRUE
CALM1	FALSE	FALSE	TRUE
TNPO2	FALSE	FALSE	TRUE
BOC	FALSE	FALSE	TRUE
KLHL13	FALSE	FALSE	TRUE
PGAP1	FALSE	FALSE	TRUE
RBFOX2	FALSE	FALSE	TRUE
TMSB10	FALSE	FALSE	TRUE
DYNLT1	FALSE	FALSE	TRUE
TMSB15B	FALSE	FALSE	TRUE
TCEAL7	FALSE	FALSE	TRUE
PTS	FALSE	FALSE	TRUE
BICD1	FALSE	FALSE	TRUE
UCHL1	FALSE	FALSE	TRUE
COMMD3	FALSE	FALSE	TRUE
MCM7	FALSE	FALSE	TRUE
AMZ2	FALSE	FALSE	TRUE
PDRG1	FALSE	FALSE	TRUE
DDAH2	FALSE	FALSE	TRUE
KLC1	FALSE	FALSE	TRUE
PCSK2	FALSE	FALSE	TRUE
OAZ1	FALSE	FALSE	TRUE
TIMM17A	FALSE	FALSE	TRUE
YWHAG	FALSE	FALSE	TRUE
CBX1	FALSE	FALSE	TRUE
SMS	FALSE	FALSE	TRUE
DGUOK	FALSE	FALSE	TRUE
SNRPG	FALSE	FALSE	TRUE
CDK6	FALSE	FALSE	TRUE
GOLT1B	FALSE	FALSE	TRUE
DUSP10	FALSE	FALSE	TRUE
ATP5J	FALSE	FALSE	TRUE
DYNLRB1	FALSE	FALSE	TRUE
TCP1	FALSE	FALSE	TRUE
GADD45G	FALSE	FALSE	TRUE
SEC31A	FALSE	FALSE	TRUE
CNOT7	FALSE	FALSE	TRUE
DDX39A	FALSE	FALSE	TRUE
SRGAP2	FALSE	FALSE	TRUE
MAST2	FALSE	FALSE	TRUE
PGK1	FALSE	FALSE	TRUE
CELF3	FALSE	FALSE	TRUE
ZFAS1	FALSE	FALSE	TRUE
ENO2	FALSE	FALSE	TRUE
SNRPB	FALSE	FALSE	TRUE
DRG1	FALSE	FALSE	TRUE
